#################################################################################################
#         #            #   #   #   #   #   #                                 #         #   #    #
#                    #   #   #   #   #   #                                   # ####### # # # #  #
########################################################### ##################       # # # # #  #
#                                                                                    #   #   #  #
#  ############################## ############################################################  #
#  #                            # #                                           #    #            #
#  #   ######################## # #             ###############               #  # #            #
#  ###                #         #               #             #               #  # #            #
#    #                #         #################      #      #               #  # #            #
#  # #                #         #                      #      #               #  # #            #
#  # #########        # #########                      #      #               #  # #            #
#  #                  #                                #                      #  #            ###
#  ############################################################################  ##############@#
#                                                                                               #
#  ################################  ##########################################  ################
#  #           #              #         #                       #             #                 #
#  #           #      #       #         #                       #             #  #              #
#  #           #      #       #         #                       #             #  #              #
#  #           #      #       #         # ####################### #############  #              #
#  #           #      #       ###########                                        #              #
#  #           #      #                   #####################################  #              #
#  #           #      #####################                                   #  #              #
#              #                                                              #  #              #
#################################################################################################