#####################################
####                             ####
####           ######################
####     ö     ######################
####                        #########
#################### ####   #########
####    Q                   #########
####        #########################
####   @    #########################
####                                #
#####################################
#####################################