▒▒▒▒▒▒▒▒▒▒▒▒▒▒▒▒▒▒▒▒▒▒▒▒▒▒▒▒▒▒▒▒▒▒▒▒▒▒▒▒▒▒▒▒▒▒▒▒▒▒▒▒▒▒▒▒▒▒▒▒▒▒▒▒▒▒▒▒▒▒▒▒▒▒▒▒▒▒▒▒▒▒▒▒▒▒▒▒▒▒▒▒▒▒▒▒▒
▒         ▒            ▒   ▒   ▒   ▒   ▒   ▒                                 ▒         ▒   ▒    ▒
▒                    ▒   ▒   ▒   ▒   ▒   ▒                                   ▒ ▒▒▒▒▒▒▒ ▒ ▒ ▒ ▒  ▒
▒▒▒▒▒▒▒▒▒▒▒▒▒▒▒▒▒▒▒▒▒▒▒▒▒▒▒▒▒▒▒▒▒▒▒▒▒▒▒▒▒▒▒▒▒▒▒▒▒▒▒▒▒▒▒▒▒▒▒ ▒▒▒▒▒▒▒▒▒▒▒▒▒▒▒▒▒▒       ▒ ▒ ▒ ▒ ▒  ▒
▒                                                                                    ▒   ▒   ▒  ▒
▒  ▒▒▒▒▒▒▒▒▒▒▒▒▒▒▒▒▒▒▒▒▒▒▒▒▒▒▒▒▒▒ ▒▒▒▒▒▒▒▒▒▒▒▒▒▒▒▒▒▒▒▒▒▒▒▒▒▒▒▒▒▒▒▒▒▒▒▒▒▒▒▒▒▒▒▒▒▒▒▒▒▒▒▒▒▒▒▒▒▒▒▒  ▒
▒  ▒                            ▒ ▒                                           ▒    ▒            ▒
▒  ▒   ▒▒▒▒▒▒▒▒▒▒▒▒▒▒▒▒▒▒▒▒▒▒▒▒ ▒ ▒             ▒▒▒▒▒▒▒▒▒▒▒▒▒▒▒               ▒  ▒ ▒            ▒
▒  ▒▒▒                ▒         ▒               ▒             ▒               ▒  ▒ ▒            ▒
▒    ▒                ▒         ▒▒▒▒▒▒▒▒▒▒▒▒▒▒▒▒▒      ▒      ▒               ▒  ▒ ▒            ▒
▒  ▒ ▒                ▒         ▒                      ▒      ▒               ▒  ▒ ▒            ▒
▒  ▒ ▒▒▒▒▒▒▒▒▒        ▒ ▒▒▒▒▒▒▒▒▒                      ▒      ▒               ▒  ▒ ▒            ▒
▒  ▒                  ▒                                ▒                      ▒  ▒            ▒▒▒
▒  ▒▒▒▒▒▒▒▒▒▒▒▒▒▒▒▒▒▒▒▒▒▒▒▒▒▒▒▒▒▒▒▒▒▒▒▒▒▒▒▒▒▒▒▒▒▒▒▒▒▒▒▒▒▒▒▒▒▒▒▒▒▒▒▒▒▒▒▒▒▒▒▒▒▒▒▒  ▒▒▒▒▒▒▒▒▒▒▒▒▒▒@▒
▒                                                                                               ▒
▒  ▒▒▒▒▒▒▒▒▒▒▒▒▒▒▒▒▒▒▒▒▒▒▒▒▒▒▒▒▒▒▒▒  ▒▒▒▒▒▒▒▒▒▒▒▒▒▒▒▒▒▒▒▒▒▒▒▒▒▒▒▒▒▒▒▒▒▒▒▒▒▒▒▒▒▒  ▒▒▒▒▒▒▒▒▒▒▒▒▒▒▒▒
▒  ▒           ▒              ▒         ▒                       ▒             ▒                 ▒
▒  ▒           ▒      ▒       ▒         ▒                       ▒             ▒  ▒              ▒
▒  ▒           ▒      ▒       ▒         ▒                       ▒             ▒  ▒              ▒
▒  ▒           ▒      ▒       ▒         ▒ ▒▒▒▒▒▒▒▒▒▒▒▒▒▒▒▒▒▒▒▒▒▒▒ ▒▒▒▒▒▒▒▒▒▒▒▒▒  ▒              ▒
▒  ▒           ▒      ▒       ▒▒▒▒▒▒▒▒▒▒▒                                        ▒              ▒
▒  ▒           ▒      ▒                   ▒▒▒▒▒▒▒▒▒▒▒▒▒▒▒▒▒▒▒▒▒▒▒▒▒▒▒▒▒▒▒▒▒▒▒▒▒  ▒              ▒
▒  ▒           ▒      ▒▒▒▒▒▒▒▒▒▒▒▒▒▒▒▒▒▒▒▒▒                                   ▒  ▒              ▒
▒              ▒                                                              ▒  ▒              ▒
▒▒▒▒▒▒▒▒▒▒▒▒▒▒▒▒▒▒▒▒▒▒▒▒▒▒▒▒▒▒▒▒▒▒▒▒▒▒▒▒▒▒▒▒▒▒▒▒▒▒▒▒▒▒▒▒▒▒▒▒▒▒▒▒▒▒▒▒▒▒▒▒▒▒▒▒▒▒▒▒▒▒▒▒▒▒▒▒▒▒▒▒▒▒▒▒▒