####################################################################################################################################################
#                                                                                                                                                  #
#                                                                                                                                                  #
#                                                                                                                                                  #
#                                                                                                                                                  #
#                                                                                                                                                  #
#                                                                                                                                                  #
#                                                                                                                                                  #
#                                                                                                                                                  #
#                                                                                                                                                  #
#                                                                                                                                                  #
#                                                                                                                                                  #
#                                                                                                                                                  #
#                                                                                                                                                  #
#                                                                                                                                                  #
#                                                                                                                                                  #
#                                                                                                                                                  #
#                                                                                                                                                  #
#                                                                                                                                                  #
#                                                                                                                                                  #
#                                                                                                                                                  #
#                                                                                                                                                  #
#                                                                                                                                                  #
#                                                                                                                                                  #
#                                                                                                                                                  #
#                                                                                                                                                  #
#                                                                                                                                                  #
#                                                                                                                                                  #
#                                                                                                                                                  #
#                                                                                                                                                  #
#                                                                                                                                                  #
#                                                                                                                                                  #
#                                                                                                                                                  #
#                                                                                                                                                  #
#                                                                                                                                                  #
#                                                                                                                                                  #
#  #                                                                                                                                               #
#  #                                                                                                                                               #
#  #                                                                                                                                               #
#  #                                                                                                                                               #
#  #                                                                                   #######                                                     #
#  #                                                  #################################                                                            #
#  #                      #############               #                                   ##########################################################
#  #         ###########              #               #  #                                #                                                        #
#  #         #     #   ############   ################   #                                #                     ################################   #
#  #         #   #   #                 #                 ##################################                     #                                  #
#  ###########   #######################                                        ö                               #  #################################
#                                                                                                              Q#                                 @#
####################################################################################################################################################