▒▒▒▒▒▒▒▒▒▒▒▒▒▒▒▒▒▒▒▒▒▒▒▒▒▒▒▒▒▒▒▒▒▒▒▒▒▒▒▒▒▒▒▒▒▒▒▒▒▒▒▒▒▒▒▒▒▒▒▒▒▒▒▒▒▒▒▒▒▒▒▒▒▒▒▒▒▒▒▒▒▒▒▒▒▒▒▒▒▒▒▒▒▒▒▒▒▒▒▒▒▒▒▒▒▒▒▒▒▒▒▒▒▒▒▒▒▒▒▒▒▒▒▒▒▒▒▒▒▒▒▒▒▒▒▒▒▒▒▒▒▒▒▒▒▒▒▒
▒                                                                                                                                                  ▒
▒                                                                                                                                                  ▒
▒                                                                                                                                                  ▒
▒                                                                                                                                                  ▒
▒                                                                                                                                                  ▒
▒                                                                                                                                                  ▒
▒                                                                                                                                                  ▒
▒                                                                                                                                                  ▒
▒                                                                                                                                                  ▒
▒                                                                                                                                                  ▒
▒                                                                                                                                                  ▒
▒                                                                                                                                                  ▒
▒                                                                                                                                                  ▒
▒                                                                                                                                                  ▒
▒                                                                                                                                                  ▒
▒                                                                                                                                                  ▒
▒                                                                                                                                                  ▒
▒                                                                                                                                                  ▒
▒                                                                                                                                                  ▒
▒                                                                                                                                                  ▒
▒                                                                                                                                                  ▒
▒                                                                                                                                                  ▒
▒                                                                                                                                                  ▒
▒                                                                                                                                                  ▒
▒                                                                                                                                                  ▒
▒                                                                                                                                                  ▒
▒                                                                                                                                                  ▒
▒                                                                                                                                                  ▒
▒                                                                                                                                                  ▒
▒                                                                                                                                                  ▒
▒                                                                                                                                                  ▒
▒                                                                                                                                                  ▒
▒                                                                                                                                                  ▒
▒                                                                                                                                                  ▒
▒                                                                                                                                                  ▒
▒  ▒                                                                                                                                               ▒
▒  ▒                                                                                                                                               ▒
▒  ▒                                                                                                                                               ▒
▒  ▒                                                                                                                                               ▒
▒  ▒                                                                                   ▒▒▒▒▒▒▒                                                     ▒
▒  ▒                                                  ▒▒▒▒▒▒▒▒▒▒▒▒▒▒▒▒▒▒▒▒▒▒▒▒▒▒▒▒▒▒▒▒▒                                                            ▒
▒  ▒                      ▒▒▒▒▒▒▒▒▒▒▒▒▒               ▒                                   ▒▒▒▒▒▒▒▒▒▒▒▒▒▒▒▒▒▒▒▒▒▒▒▒▒▒▒▒▒▒▒▒▒▒▒▒▒▒▒▒▒▒▒▒▒▒▒▒▒▒▒▒▒▒▒▒▒▒
▒  ▒         ▒▒▒▒▒▒▒▒▒▒▒              ▒               ▒  ▒                                ▒                                                        ▒
▒  ▒         ▒     ▒   ▒▒▒▒▒▒▒▒▒▒▒▒   ▒▒▒▒▒▒▒▒▒▒▒▒▒▒▒▒   ▒                                ▒                     ▒▒▒▒▒▒▒▒▒▒▒▒▒▒▒▒▒▒▒▒▒▒▒▒▒▒▒▒▒▒▒▒   ▒
▒  ▒         ▒   ▒   ▒                 ▒                 ▒▒▒▒▒▒▒▒▒▒▒▒▒▒▒▒▒▒▒▒▒▒▒▒▒▒▒▒▒▒▒▒▒▒                     ▒                                  ▒
▒  ▒▒▒▒▒▒▒▒▒▒▒   ▒▒▒▒▒▒▒▒▒▒▒▒▒▒▒▒▒▒▒▒▒▒▒                                        ö                               ▒  ▒▒▒▒▒▒▒▒▒▒▒▒▒▒▒▒▒▒▒▒▒▒▒▒▒▒▒▒▒▒▒▒▒
▒                                                                                                              Q▒                                 @▒
▒▒▒▒▒▒▒▒▒▒▒▒▒▒▒▒▒▒▒▒▒▒▒▒▒▒▒▒▒▒▒▒▒▒▒▒▒▒▒▒▒▒▒▒▒▒▒▒▒▒▒▒▒▒▒▒▒▒▒▒▒▒▒▒▒▒▒▒▒▒▒▒▒▒▒▒▒▒▒▒▒▒▒▒▒▒▒▒▒▒▒▒▒▒▒▒▒▒▒▒▒▒▒▒▒▒▒▒▒▒▒▒▒▒▒▒▒▒▒▒▒▒▒▒▒▒▒▒▒▒▒▒▒▒▒▒▒▒▒▒▒▒▒▒▒▒▒▒