#####################################
####              i              ####
####  ʇ        ######################
####     ö     ######################
####                        #########
#################### #### ♥ #########
####    Q                   #########
####        #########################
####   @    #########################
####                                #
#####################################
#####################################