#####################################
####                             ####
####           ######################
####     ö     ######################
####                        #########
#################### ####   #########
####    Q                   #########
####        #########################
####        #########################
####                               @#
#####################################
#####################################