#####################################
####                             ####
####           ######################
####           ######################
####                        #########
#################### ####   #########
####                        #########
####        #########################
####        #########################
####                               0#
#####################################
#####################################