#####################################
####                             ####
####           ######################
####           ######################
####                        #########
#################### ####   #########
####    %                   #########
####        #########################
####        #########################
####                               @#
#####################################
#####################################